аак	NOUN
аба	NOUN
ава	NOUN
аво	NOUN
ага	NOUN
аер	NOUN
азу	NOUN
азы	NOUN
аид	NOUN
аил	NOUN
аир	NOUN
айн	NOUN
акк	NOUN
акр	NOUN
акт	NOUN
ала	NOUN
амт	NOUN
ант	NOUN
ара	NOUN
арк	NOUN
арт	NOUN
арх	NOUN
аск	NOUN
асс	NOUN
ать	NOUN
аул	NOUN
аут	NOUN
ахи	NOUN
аче	NOUN
аше	NOUN
аэд	NOUN
аят	NOUN
баг	NOUN
баз	NOUN
бай	NOUN
бак	NOUN
бал	NOUN
бан	NOUN
бар	NOUN
бас	NOUN
бат	NOUN
баф	NOUN
бах	NOUN
баш	NOUN
бег	NOUN
бей	NOUN
бек	NOUN
бел	NOUN
бес	NOUN
биг	NOUN
бид	NOUN
бий	NOUN
био	NOUN
бис	NOUN
бит	NOUN
бич	NOUN
бка	NOUN
боа	NOUN
боб	NOUN
бог	NOUN
бод	NOUN
бой	NOUN
бок	NOUN
бон	NOUN
боп	NOUN
бор	NOUN
бот	NOUN
бош	NOUN
бра	NOUN
бри	NOUN
бро	NOUN
буж	NOUN
буй	NOUN
бук	NOUN
бум	NOUN
бур	NOUN
бус	NOUN
бут	NOUN
бух	NOUN
буц	NOUN
буш	NOUN
бык	NOUN
быр	NOUN
быт	NOUN
бэг	NOUN
бэп	NOUN
бэр	NOUN
вад	NOUN
важ	NOUN
вал	NOUN
ван	NOUN
вап	NOUN
вар	NOUN
вдк	NOUN
веб	NOUN
век	NOUN
вес	NOUN
вех	NOUN
виг	NOUN
вид	NOUN
вип	NOUN
вир	NOUN
вис	NOUN
вич	NOUN
вод	NOUN
вож	NOUN
воз	NOUN
вой	NOUN
вок	NOUN
вол	NOUN
вор	NOUN
вуд	NOUN
вуз	NOUN
вуй	NOUN
вша	NOUN
выя	NOUN
вэб	NOUN
вэн	NOUN
вяз	NOUN
вяк	NOUN
гад	NOUN
газ	NOUN
гай	NOUN
гак	NOUN
гал	NOUN
гам	NOUN
гас	NOUN
гау	NOUN
гаф	NOUN
гаш	NOUN
гез	NOUN
гей	NOUN
гем	NOUN
ген	NOUN
гиг	NOUN
гид	NOUN
гик	NOUN
гин	NOUN
гит	NOUN
гну	NOUN
год	NOUN
гой	NOUN
гол	NOUN
гон	NOUN
гот	NOUN
гск	NOUN
гуа	NOUN
гуд	NOUN
гуж	NOUN
гук	NOUN
гул	NOUN
гун	NOUN
гэг	NOUN
гэл	NOUN
гэп	NOUN
даб	NOUN
даг	NOUN
дад	NOUN
дак	NOUN
дал	NOUN
дан	NOUN
дао	NOUN
дар	NOUN
дед	NOUN
дез	NOUN
дек	NOUN
дем	NOUN
дер	NOUN
дзю	NOUN
див	NOUN
диг	NOUN
дик	NOUN
дно	NOUN
дог	NOUN
дож	NOUN
док	NOUN
дол	NOUN
дом	NOUN
дон	NOUN
доп	NOUN
дот	NOUN
дуб	NOUN
дуо	NOUN
дур	NOUN
дух	NOUN
душ	NOUN
дым	NOUN
дых	NOUN
дэв	NOUN
дэз	NOUN
дюк	NOUN
ева	NOUN
еда	NOUN
ежа	NOUN
ект	NOUN
ела	NOUN
ель	NOUN
ема	NOUN
ень	NOUN
ера	NOUN
ерш	NOUN
еры	NOUN
ерь	NOUN
ета	NOUN
жад	NOUN
жар	NOUN
жид	NOUN
жим	NOUN
жир	NOUN
жог	NOUN
жок	NOUN
жом	NOUN
жор	NOUN
жох	NOUN
жуз	NOUN
жук	NOUN
жэк	NOUN
зав	NOUN
зад	NOUN
зал	NOUN
зам	NOUN
зая	NOUN
зга	NOUN
зев	NOUN
зек	NOUN
зет	NOUN
зик	NOUN
зил	NOUN
зим	NOUN
зин	NOUN
зис	NOUN
зло	NOUN
зоб	NOUN
зов	NOUN
зрк	NOUN
зуб	NOUN
зуд	NOUN
зуз	NOUN
зуй	NOUN
зум	NOUN
зык	NOUN
зэк	NOUN
ибн	NOUN
ибо	NOUN
ива	NOUN
иго	NOUN
идо	NOUN
иды	NOUN
иже	NOUN
изм	NOUN
изо	NOUN
икс	NOUN
икт	NOUN
ила	NOUN
иль	NOUN
имя	NOUN
ина	NOUN
инк	NOUN
инь	NOUN
иод	NOUN
иол	NOUN
ион	NOUN
иох	NOUN
иск	NOUN
ист	NOUN
ить	NOUN
ица	NOUN
йог	NOUN
йод	NOUN
йот	NOUN
йух	NOUN
кал	NOUN
кам	NOUN
кан	NOUN
кап	NOUN
кар	NOUN
кат	NOUN
кач	NOUN
ква	NOUN
кгс	NOUN
кеб	NOUN
кег	NOUN
кед	NOUN
кек	NOUN
кен	NOUN
кеп	NOUN
кер	NOUN
кет	NOUN
кеч	NOUN
кеш	NOUN
кий	NOUN
кик	NOUN
кил	NOUN
кип	NOUN
кир	NOUN
кит	NOUN
кич	NOUN
коб	NOUN
код	NOUN
кок	NOUN
кол	NOUN
ком	NOUN
кон	NOUN
коп	NOUN
кор	NOUN
кот	NOUN
коф	NOUN
коч	NOUN
кош	NOUN
кпд	NOUN
кри	NOUN
кси	NOUN
куб	NOUN
кум	NOUN
кун	NOUN
кур	NOUN
кус	NOUN
кут	NOUN
куш	NOUN
кэб	NOUN
кэп	NOUN
кэт	NOUN
кэф	NOUN
кэш	NOUN
лаг	NOUN
лад	NOUN
лаж	NOUN
лаз	NOUN
лай	NOUN
лак	NOUN
лал	NOUN
лан	NOUN
лао	NOUN
лар	NOUN
лат	NOUN
лев	NOUN
лед	NOUN
лей	NOUN
лек	NOUN
лен	NOUN
лес	NOUN
лёс	NOUN
лет	NOUN
лёт	NOUN
лещ	NOUN
лея	NOUN
лжа	NOUN
лид	NOUN
лик	NOUN
лис	NOUN
лит	NOUN
лиф	NOUN
лич	NOUN
лка	NOUN
лоб	NOUN
лов	NOUN
лог	NOUN
лок	NOUN
лом	NOUN
лор	NOUN
лот	NOUN
лоф	NOUN
лох	NOUN
луб	NOUN
луг	NOUN
луз	NOUN
лук	NOUN
луп	NOUN
лур	NOUN
луч	NOUN
лье	NOUN
люд	NOUN
люк	NOUN
ляд	NOUN
лям	NOUN
лян	NOUN
ляп	NOUN
лях	NOUN
маг	NOUN
мае	NOUN
маз	NOUN
май	NOUN
мак	NOUN
мар	NOUN
мат	NOUN
мах	NOUN
маш	NOUN
мга	NOUN
мег	NOUN
мед	NOUN
мел	NOUN
мем	NOUN
мер	NOUN
мех	NOUN
мец	NOUN
меч	NOUN
меш	NOUN
миг	NOUN
мил	NOUN
мим	NOUN
мир	NOUN
миф	NOUN
мка	NOUN
млн	NOUN
мня	NOUN
моа	NOUN
моб	NOUN
мод	NOUN
мол	NOUN
мор	NOUN
мот	NOUN
мох	NOUN
мпа	NOUN
мск	NOUN
муж	NOUN
мул	NOUN
мык	NOUN
мыс	NOUN
мыт	NOUN
мыш	NOUN
мэм	NOUN
мэн	NOUN
мэр	NOUN
мяо	NOUN
мяу	NOUN
мяч	NOUN
нал	NOUN
нар	NOUN
наш	NOUN
нет	NOUN
неф	NOUN
нец	NOUN
низ	NOUN
ний	NOUN
ник	NOUN
ним	NOUN
нит	NOUN
ниц	NOUN
нод	NOUN
нож	NOUN
ной	NOUN
нок	NOUN
ном	NOUN
нос	NOUN
нуб	NOUN
нун	NOUN
нус	NOUN
нут	NOUN
нык	NOUN
нэп	NOUN
нюх	NOUN
оаз	NOUN
оби	NOUN
обо	NOUN
обр	NOUN
ова	NOUN
ово	NOUN
огр	NOUN
ода	NOUN
одр	NOUN
око	NOUN
они	NOUN
опт	NOUN
орг	NOUN
орк	NOUN
орт	NOUN
оса	NOUN
оси	NOUN
ост	NOUN
ось	NOUN
оть	NOUN
охи	NOUN
очи	NOUN
паб	NOUN
паж	NOUN
паз	NOUN
пай	NOUN
пак	NOUN
пал	NOUN
пан	NOUN
пар	NOUN
пас	NOUN
пат	NOUN
пах	NOUN
пед	NOUN
пек	NOUN
пес	NOUN
пет	NOUN
пик	NOUN
пим	NOUN
пин	NOUN
пир	NOUN
пит	NOUN
пиф	NOUN
пих	NOUN
пли	NOUN
под	NOUN
пол	NOUN
пом	NOUN
поп	NOUN
пот	NOUN
поц	NOUN
ппц	NOUN
при	NOUN
пря	NOUN
пси	NOUN
пуд	NOUN
пук	NOUN
пул	NOUN
пуп	NOUN
пуф	NOUN
пух	NOUN
пыж	NOUN
пыл	NOUN
пых	NOUN
пье	NOUN
пья	NOUN
пэр	NOUN
раб	NOUN
рав	NOUN
рад	NOUN
раж	NOUN
раз	NOUN
рай	NOUN
рак	NOUN
раф	NOUN
раш	NOUN
рев	NOUN
рег	NOUN
рез	NOUN
рей	NOUN
реф	NOUN
рея	NOUN
ржа	NOUN
рип	NOUN
рис	NOUN
риф	NOUN
ров	NOUN
рог	NOUN
род	NOUN
рой	NOUN
рок	NOUN
рол	NOUN
ром	NOUN
рос	NOUN
рот	NOUN
руд	NOUN
рум	NOUN
рус	NOUN
рцы	NOUN
рык	NOUN
рым	NOUN
рэй	NOUN
рэп	NOUN
рюх	NOUN
рюш	NOUN
ряд	NOUN
ряж	NOUN
саб	NOUN
сад	NOUN
саж	NOUN
саз	NOUN
сак	NOUN
сам	NOUN
сан	NOUN
сап	NOUN
сев	NOUN
сед	NOUN
сет	NOUN
сец	NOUN
сиг	NOUN
сид	NOUN
сип	NOUN
сир	NOUN
сиф	NOUN
ска	NOUN
сок	NOUN
сом	NOUN
сон	NOUN
сор	NOUN
сот	NOUN
соя	NOUN
спа	NOUN
сти	NOUN
сто	NOUN
стя	NOUN
суд	NOUN
сук	NOUN
сум	NOUN
суп	NOUN
сур	NOUN
сын	NOUN
сыр	NOUN
сыч	NOUN
сэр	NOUN
сюр	NOUN
таз	NOUN
таи	NOUN
тай	NOUN
тал	NOUN
тан	NOUN
тап	NOUN
тар	NOUN
тат	NOUN
тау	NOUN
тах	NOUN
таю	NOUN
тви	NOUN
тег	NOUN
тер	NOUN
тес	NOUN
тие	NOUN
тик	NOUN
тин	NOUN
тип	NOUN
тир	NOUN
тис	NOUN
тиф	NOUN
тло	NOUN
тля	NOUN
той	NOUN
ток	NOUN
тол	NOUN
том	NOUN
тон	NOUN
топ	NOUN
тор	NOUN
тот	NOUN
туз	NOUN
тук	NOUN
тул	NOUN
тун	NOUN
тур	NOUN
тут	NOUN
туф	NOUN
туш	NOUN
туя	NOUN
тый	NOUN
тык	NOUN
тыл	NOUN
тын	NOUN
тэн	NOUN
тюб	NOUN
тюк	NOUN
тяг	NOUN
тяж	NOUN
тям	NOUN
тян	NOUN
угр	NOUN
уда	NOUN
удк	NOUN
уду	NOUN
удэ	NOUN
уем	NOUN
уза	NOUN
узг	NOUN
узы	NOUN
уке	NOUN
уки	NOUN
укр	NOUN
ула	NOUN
унт	NOUN
упс	NOUN
ура	NOUN
урк	NOUN
усы	NOUN
ута	NOUN
утя	NOUN
уха	NOUN
ухо	NOUN
уши	NOUN
ушу	NOUN
уют	NOUN
фаг	NOUN
фай	NOUN
фак	NOUN
фал	NOUN
фан	NOUN
фап	NOUN
фас	NOUN
фат	NOUN
фау	NOUN
фен	NOUN
фес	NOUN
фея	NOUN
фиг	NOUN
фид	NOUN
фин	NOUN
фиш	NOUN
фоб	NOUN
фок	NOUN
фол	NOUN
фон	NOUN
фот	NOUN
фра	NOUN
фру	NOUN
фря	NOUN
фуа	NOUN
фук	NOUN
фут	NOUN
фэн	NOUN
фэр	NOUN
хаб	NOUN
хав	NOUN
хаз	NOUN
хай	NOUN
хак	NOUN
хам	NOUN
хан	NOUN
хао	NOUN
хач	NOUN
хаш	NOUN
хек	NOUN
хер	NOUN
хеш	NOUN
хип	NOUN
хит	NOUN
хна	NOUN
ход	NOUN
хон	NOUN
хор	NOUN
хуй	NOUN
хук	NOUN
хум	NOUN
хур	NOUN
хэш	NOUN
цеж	NOUN
цек	NOUN
цеп	NOUN
цех	NOUN
ция	NOUN
цуг	NOUN
цук	NOUN
цян	NOUN
чав	NOUN
чад	NOUN
чай	NOUN
чал	NOUN
чан	NOUN
час	NOUN
чат	NOUN
чви	NOUN
чек	NOUN
чел	NOUN
чес	NOUN
чет	NOUN
чех	NOUN
чиж	NOUN
чий	NOUN
чик	NOUN
чин	NOUN
чип	NOUN
чир	NOUN
чит	NOUN
чиф	NOUN
чих	NOUN
чмо	NOUN
чок	NOUN
чон	NOUN
чоп	NOUN
чох	NOUN
чуб	NOUN
чум	NOUN
чур	NOUN
чюм	NOUN
чяб	NOUN
шаг	NOUN
шан	NOUN
шар	NOUN
шаф	NOUN
шах	NOUN
шва	NOUN
шед	NOUN
шек	NOUN
шер	NOUN
шеф	NOUN
шея	NOUN
шиз	NOUN
шик	NOUN
шип	NOUN
шиш	NOUN
шка	NOUN
шов	NOUN
шок	NOUN
шоп	NOUN
шот	NOUN
шоу	NOUN
шуб	NOUN
шуй	NOUN
шум	NOUN
шут	NOUN
шэн	NOUN
щен	NOUN
щец	NOUN
щик	NOUN
щип	NOUN
щит	NOUN
щуп	NOUN
щур	NOUN
эве	NOUN
эго	NOUN
эйс	NOUN
экю	NOUN
эль	NOUN
эмо	NOUN
эму	NOUN
энд	NOUN
эон	NOUN
эра	NOUN
эрг	NOUN
эре	NOUN
эрл	NOUN
эст	NOUN
эта	NOUN
это	NOUN
эфа	NOUN
эхо	NOUN
юга	NOUN
юго	NOUN
юит	NOUN
юла	NOUN
юра	NOUN
юри	NOUN
юрт	NOUN
явь	NOUN
яга	NOUN
ядь	NOUN
язь	NOUN
яма	NOUN
ямб	NOUN
ямс	NOUN
янь	NOUN
ярд	NOUN
ярл	NOUN
ярь	NOUN
ять	NOUN
Аав	PROPN
Аар	PROPN
Аба	PROPN
Абд	PROPN
Аби	PROPN
Або	PROPN
Абу	PROPN
Ава	PROPN
Ага	PROPN
Агн	PROPN
Аго	PROPN
Ада	PROPN
Ади	PROPN
Аду	PROPN
Адя	PROPN
Ажа	PROPN
Ажи	PROPN
Ажу	PROPN
Аза	PROPN
Азе	PROPN
Ази	PROPN
Азу	PROPN
Азя	PROPN
Аид	PROPN
Аим	PROPN
Аин	PROPN
Айе	PROPN
Айя	PROPN
Ака	PROPN
Аки	PROPN
Ако	PROPN
Акр	PROPN
Ала	PROPN
Але	PROPN
Али	PROPN
Ало	PROPN
Алу	PROPN
Алы	PROPN
Алэ	PROPN
Аля	PROPN
Ама	PROPN
Амс	PROPN
Аму	PROPN
Ана	PROPN
Ани	PROPN
Ану	PROPN
Ань	PROPN
Анэ	PROPN
Аня	PROPN
Апа	PROPN
Апе	PROPN
Апи	PROPN
Апу	PROPN
Ара	PROPN
Аре	PROPN
Арс	PROPN
Арт	PROPN
Ару	PROPN
Аря	PROPN
Аса	PROPN
Асс	PROPN
Асу	PROPN
Ася	PROPN
Ата	PROPN
Ати	PROPN
Ату	PROPN
Атя	PROPN
Ауд	PROPN
Ауф	PROPN
Афа	PROPN
Афр	PROPN
Аха	PROPN
Аху	PROPN
Аца	PROPN
Аци	PROPN
Ача	PROPN
Аша	PROPN
Ашт	PROPN
Ашу	PROPN
Аюб	PROPN
Аян	PROPN
Аят	PROPN
Баа	PROPN
Баб	PROPN
Баг	PROPN
Бад	PROPN
Баж	PROPN
Баз	PROPN
Бай	PROPN
Бак	PROPN
Бао	PROPN
Бар	PROPN
Бат	PROPN
Бах	PROPN
Бач	PROPN
Баш	PROPN
Бая	PROPN
Бег	PROPN
Бей	PROPN
Бек	PROPN
Бел	PROPN
Бем	PROPN
Бен	PROPN
Бер	PROPN
Бес	PROPN
Бет	PROPN
Беч	PROPN
Бея	PROPN
Бжо	PROPN
Бза	PROPN
Бзи	PROPN
Биа	PROPN
Биб	PROPN
Бид	PROPN
Бий	PROPN
Бин	PROPN
Бис	PROPN
Биц	PROPN
Бич	PROPN
Бия	PROPN
Бло	PROPN
Боб	PROPN
Бог	PROPN
Боз	PROPN
Бой	PROPN
Бол	PROPN
Бом	PROPN
Бор	PROPN
Бот	PROPN
Бох	PROPN
Буа	PROPN
Буб	PROPN
Буг	PROPN
Буй	PROPN
Бук	PROPN
Бун	PROPN
Бур	PROPN
Бут	PROPN
Бух	PROPN
Буц	PROPN
Буш	PROPN
Быб	PROPN
Быг	PROPN
Быд	PROPN
Бык	PROPN
Быт	PROPN
Быц	PROPN
Быч	PROPN
Бэл	PROPN
Бэр	PROPN
Вад	PROPN
Ваз	PROPN
Вай	PROPN
Ван	PROPN
Вар	PROPN
Ват	PROPN
Вах	PROPN
Вая	PROPN
Вел	PROPN
Вея	PROPN
Вид	PROPN
Вий	PROPN
Вик	PROPN
Вил	PROPN
Вир	PROPN
Вис	PROPN
Вит	PROPN
Вич	PROPN
Вия	PROPN
Воз	PROPN
Вой	PROPN
Вол	PROPN
Воя	PROPN
Вуд	PROPN
Выг	PROPN
Вяо	PROPN
Гаг	PROPN
Гаж	PROPN
Газ	PROPN
Гай	PROPN
Гак	PROPN
Гал	PROPN
Ган	PROPN
Гар	PROPN
Гас	PROPN
Гау	PROPN
Гач	PROPN
Гаш	PROPN
Гая	PROPN
Гди	PROPN
Гды	PROPN
Геа	PROPN
Гек	PROPN
Гем	PROPN
Гец	PROPN
Геч	PROPN
Гея	PROPN
Гза	PROPN
Гид	PROPN
Гиз	PROPN
Гик	PROPN
Гио	PROPN
Гич	PROPN
Гия	PROPN
Гну	PROPN
Гоа	PROPN
Гог	PROPN
Гок	PROPN
Гон	PROPN
Гоп	PROPN
Гор	PROPN
Гос	PROPN
Гоф	PROPN
Гоц	PROPN
Гри	PROPN
Гуд	PROPN
Гуж	PROPN
Гук	PROPN
Гул	PROPN
Гум	PROPN
Гур	PROPN
Гус	PROPN
Гут	PROPN
Гуч	PROPN
Гыб	PROPN
Гыг	PROPN
Гыд	PROPN
Гыж	PROPN
Гыт	PROPN
Гью	PROPN
Гюй	PROPN
Гюл	PROPN
Гян	PROPN
Даг	PROPN
Дад	PROPN
Даи	PROPN
Дай	PROPN
Дак	PROPN
Дал	PROPN
Дам	PROPN
Дан	PROPN
Дао	PROPN
Дар	PROPN
Дат	PROPN
Дах	PROPN
Дач	PROPN
Даш	PROPN
Дед	PROPN
Дей	PROPN
Дем	PROPN
Ден	PROPN
Део	PROPN
Деп	PROPN
Дес	PROPN
Дея	PROPN
Джо	PROPN
Джу	PROPN
Дзу	PROPN
Див	PROPN
Дий	PROPN
Дик	PROPN
Дим	PROPN
Дин	PROPN
Дир	PROPN
Диц	PROPN
Дия	PROPN
Дно	PROPN
Дои	PROPN
Док	PROPN
Дол	PROPN
Дон	PROPN
Доу	PROPN
Дуг	PROPN
Дуд	PROPN
Дун	PROPN
Дур	PROPN
Дуэ	PROPN
Дыд	PROPN
Дый	PROPN
Дыу	PROPN
Дых	PROPN
Дыч	PROPN
Дэв	PROPN
Дэк	PROPN
Дэу	PROPN
Дюк	PROPN
Дюр	PROPN
Дян	PROPN
Ева	PROPN
Ега	PROPN
Едо	PROPN
Еды	PROPN
Еза	PROPN
Ека	PROPN
Ела	PROPN
Елю	PROPN
Еля	PROPN
Ема	PROPN
Ена	PROPN
Ени	PROPN
Еня	PROPN
Ера	PROPN
Ерм	PROPN
Еря	PROPN
Еса	PROPN
Есе	PROPN
Еси	PROPN
Еся	PROPN
Ета	PROPN
Ефа	PROPN
Еша	PROPN
Жаа	PROPN
Жак	PROPN
Жал	PROPN
Жан	PROPN
Жап	PROPN
Жау	PROPN
Жац	PROPN
Жек	PROPN
Жид	PROPN
Жип	PROPN
Жув	PROPN
Жуж	PROPN
Жуй	PROPN
Жук	PROPN
Жун	PROPN
Жур	PROPN
Жыж	PROPN
Зай	PROPN
Зак	PROPN
Зал	PROPN
Зан	PROPN
Зач	PROPN
Зая	PROPN
Зел	PROPN
Зем	PROPN
Зет	PROPN
Зеф	PROPN
Зея	PROPN
Зик	PROPN
Зия	PROPN
Зна	PROPN
Зон	PROPN
Зот	PROPN
Зоя	PROPN
Зуй	PROPN
Зух	PROPN
Зуя	PROPN
Зык	PROPN
Иак	PROPN
Иба	PROPN
Иби	PROPN
Ибэ	PROPN
Ива	PROPN
Ига	PROPN
Ида	PROPN
Иды	PROPN
Иен	PROPN
Иза	PROPN
Изи	PROPN
Изо	PROPN
Изя	PROPN
Иин	PROPN
Ика	PROPN
Икс	PROPN
Ила	PROPN
Или	PROPN
Ило	PROPN
Илу	PROPN
Иль	PROPN
Иля	PROPN
Има	PROPN
Ими	PROPN
Ина	PROPN
Инб	PROPN
Инд	PROPN
Инк	PROPN
Иня	PROPN
Иов	PROPN
Ион	PROPN
Ипр	PROPN
Ира	PROPN
Иса	PROPN
Исе	PROPN
Иси	PROPN
Ису	PROPN
Ися	PROPN
Ита	PROPN
Ито	PROPN
Ить	PROPN
Иуа	PROPN
Иха	PROPN
Ихи	PROPN
Ихэ	PROPN
Ица	PROPN
Ича	PROPN
Иша	PROPN
Каб	PROPN
Кав	PROPN
Каз	PROPN
Каи	PROPN
Кай	PROPN
Кам	PROPN
Кан	PROPN
Кап	PROPN
Кар	PROPN
Кас	PROPN
Кау	PROPN
Каф	PROPN
Ках	PROPN
Кац	PROPN
Кач	PROPN
Каш	PROPN
Кая	PROPN
Кды	PROPN
Кез	PROPN
Кем	PROPN
Кен	PROPN
Кеп	PROPN
Кер	PROPN
Кет	PROPN
Кец	PROPN
Кеч	PROPN
Кея	PROPN
Киа	PROPN
Киг	PROPN
Киж	PROPN
Киз	PROPN
Кий	PROPN
Ким	PROPN
Кин	PROPN
Кио	PROPN
Кир	PROPN
Кис	PROPN
Кит	PROPN
Кищ	PROPN
Кия	PROPN
Клу	PROPN
Кмо	PROPN
Коз	PROPN
Кой	PROPN
Кон	PROPN
Коп	PROPN
Кор	PROPN
Кос	PROPN
Кот	PROPN
Кох	PROPN
Кош	PROPN
Кри	PROPN
Ксю	PROPN
Куж	PROPN
Куз	PROPN
Куи	PROPN
Кук	PROPN
Кул	PROPN
Кун	PROPN
Кур	PROPN
Кут	PROPN
Куц	PROPN
Куч	PROPN
Куш	PROPN
Кцу	PROPN
Кыж	PROPN
Кыз	PROPN
Кый	PROPN
Кык	PROPN
Кым	PROPN
Кып	PROPN
Кыс	PROPN
Кыт	PROPN
Кыф	PROPN
Кыч	PROPN
Кэв	PROPN
Кюи	PROPN
Кюй	PROPN
Кюк	PROPN
Кюн	PROPN
Кяс	PROPN
Лаг	PROPN
Лад	PROPN
Лаз	PROPN
Лам	PROPN
Лао	PROPN
Лас	PROPN
Лат	PROPN
Лау	PROPN
Лах	PROPN
Лац	PROPN
Лая	PROPN
Лев	PROPN
Лей	PROPN
Лем	PROPN
Лен	PROPN
Лео	PROPN
Леф	PROPN
Лех	PROPN
Лец	PROPN
Лея	PROPN
Лжа	PROPN
Либ	PROPN
Лид	PROPN
Лиз	PROPN
Лил	PROPN
Лин	PROPN
Лир	PROPN
Лит	PROPN
Лия	PROPN
Лой	PROPN
Лоо	PROPN
Лос	PROPN
Лот	PROPN
Лоу	PROPN
Лох	PROPN
Луз	PROPN
Луи	PROPN
Луй	PROPN
Лук	PROPN
Лун	PROPN
Луп	PROPN
Лут	PROPN
Лух	PROPN
Лык	PROPN
Лып	PROPN
Лыт	PROPN
Лых	PROPN
Лэм	PROPN
Люй	PROPN
Люк	PROPN
Лют	PROPN
Люц	PROPN
Лян	PROPN
Ляс	PROPN
Ляу	PROPN
Лях	PROPN
Маа	PROPN
Маз	PROPN
Маи	PROPN
Май	PROPN
Мак	PROPN
Мал	PROPN
Мао	PROPN
Мар	PROPN
Мас	PROPN
Мат	PROPN
Мау	PROPN
Маф	PROPN
Мах	PROPN
Мац	PROPN
Мач	PROPN
Маш	PROPN
Мая	PROPN
Мга	PROPN
Мда	PROPN
Мды	PROPN
Мег	PROPN
Мед	PROPN
Мез	PROPN
Мей	PROPN
Мен	PROPN
Мер	PROPN
Мец	PROPN
Меч	PROPN
Мея	PROPN
Мжа	PROPN
Мзы	PROPN
Миа	PROPN
Миг	PROPN
Мир	PROPN
Мод	PROPN
Мор	PROPN
Мос	PROPN
Муи	PROPN
Мук	PROPN
Мур	PROPN
Мус	PROPN
Мут	PROPN
Муя	PROPN
Мчы	PROPN
Мыд	PROPN
Мыз	PROPN
Мык	PROPN
Мыр	PROPN
Мыс	PROPN
Мыт	PROPN
Мыч	PROPN
Мыш	PROPN
Мэб	PROPN
Мэи	PROPN
Мэй	PROPN
Мэн	PROPN
Мэя	PROPN
Мюр	PROPN
Наз	PROPN
Най	PROPN
Нам	PROPN
Нан	PROPN
Нар	PROPN
Нас	PROPN
Нау	PROPN
Нах	PROPN
Наш	PROPN
Ная	PROPN
Нго	PROPN
Нег	PROPN
Ней	PROPN
Нем	PROPN
Неш	PROPN
Нея	PROPN
Ник	PROPN
Нил	PROPN
Ним	PROPN
Нит	PROPN
Ниш	PROPN
Ной	PROPN
Нот	PROPN
Ноу	PROPN
Нох	PROPN
Ноя	PROPN
Нун	PROPN
Нур	PROPN
Нут	PROPN
Нух	PROPN
Нуя	PROPN
Ныз	PROPN
Ным	PROPN
Ныс	PROPN
Нэф	PROPN
Нюя	PROPN
Няз	PROPN
Оба	PROPN
Обь	PROPN
Ова	PROPN
Оги	PROPN
Ода	PROPN
Оза	PROPN
Ойе	PROPN
Ока	PROPN
Окс	PROPN
Оку	PROPN
Ола	PROPN
Оле	PROPN
Оли	PROPN
Оль	PROPN
Оля	PROPN
Ома	PROPN
Омь	PROPN
Они	PROPN
Оня	PROPN
Оот	PROPN
Опа	PROPN
Ора	PROPN
Орк	PROPN
Орь	PROPN
Оря	PROPN
Оса	PROPN
Ост	PROPN
Осу	PROPN
Ося	PROPN
Ота	PROPN
Ото	PROPN
Отс	PROPN
Отя	PROPN
Оха	PROPN
Оцу	PROPN
Очи	PROPN
Оша	PROPN
Оши	PROPN
Паг	PROPN
Паж	PROPN
Паз	PROPN
Пак	PROPN
Пал	PROPN
Пам	PROPN
Пан	PROPN
Пап	PROPN
Пас	PROPN
Пат	PROPN
Паф	PROPN
Пах	PROPN
Пац	PROPN
Пач	PROPN
Паш	PROPN
Пек	PROPN
Пел	PROPN
Пен	PROPN
Пеп	PROPN
Пер	PROPN
Пес	PROPN
Пет	PROPN
Печ	PROPN
Пея	PROPN
Пиа	PROPN
Пии	PROPN
Пий	PROPN
Пик	PROPN
Пим	PROPN
Пио	PROPN
Пип	PROPN
Пир	PROPN
Пит	PROPN
Пиф	PROPN
Пиц	PROPN
Пия	PROPN
Поз	PROPN
Пол	PROPN
Поп	PROPN
Пор	PROPN
Пох	PROPN
Пра	PROPN
Пре	PROPN
При	PROPN
Про	PROPN
Пси	PROPN
Пти	PROPN
Пуд	PROPN
Пуп	PROPN
Пур	PROPN
Пуц	PROPN
Пцу	PROPN
Пыж	PROPN
Пыр	PROPN
Пыс	PROPN
Пыт	PROPN
Пыц	PROPN
Пыч	PROPN
Пыш	PROPN
Пэн	PROPN
Рад	PROPN
Рак	PROPN
Рам	PROPN
Ран	PROPN
Рас	PROPN
Рат	PROPN
Рау	PROPN
Раш	PROPN
Рая	PROPN
Рев	PROPN
Рее	PROPN
Реж	PROPN
Рей	PROPN
Рем	PROPN
Реч	PROPN
Реш	PROPN
Рея	PROPN
Рид	PROPN
Рим	PROPN
Рио	PROPN
Рип	PROPN
Рис	PROPN
Роб	PROPN
Рог	PROPN
Роз	PROPN
Рой	PROPN
Рон	PROPN
Рос	PROPN
Рот	PROPN
Роу	PROPN
Роф	PROPN
Руа	PROPN
Руд	PROPN
Руж	PROPN
Рук	PROPN
Рум	PROPN
Рур	PROPN
Рус	PROPN
Рут	PROPN
Руф	PROPN
Рух	PROPN
Рыж	PROPN
Рыч	PROPN
Рэп	PROPN
Рэу	PROPN
Ряз	PROPN
Саа	PROPN
Сад	PROPN
Саи	PROPN
Сал	PROPN
Сам	PROPN
Сан	PROPN
Сап	PROPN
Сас	PROPN
Сау	PROPN
Сац	PROPN
Сев	PROPN
Сед	PROPN
Сем	PROPN
Сен	PROPN
Сер	PROPN
Сет	PROPN
Сеф	PROPN
Сиб	PROPN
Сид	PROPN
Сиз	PROPN
Сим	PROPN
Сит	PROPN
Сиф	PROPN
Сия	PROPN
Сйе	PROPN
Сож	PROPN
Сок	PROPN
Сол	PROPN
Сон	PROPN
Соу	PROPN
Соя	PROPN
Спа	PROPN
Суй	PROPN
Сум	PROPN
Сун	PROPN
Суп	PROPN
Сур	PROPN
Сут	PROPN
Сфи	PROPN
Сым	PROPN
Сыс	PROPN
Сыт	PROPN
Сыу	PROPN
Сэм	PROPN
Сэн	PROPN
Сюй	PROPN
Сюш	PROPN
Сяо	PROPN
Таж	PROPN
Таз	PROPN
Тай	PROPN
Тан	PROPN
Тао	PROPN
Тап	PROPN
Тас	PROPN
Тат	PROPN
Тау	PROPN
Тац	PROPN
Тач	PROPN
Таш	PROPN
Тая	PROPN
Теб	PROPN
Тед	PROPN
Тео	PROPN
Тея	PROPN
Тик	PROPN
Тим	PROPN
Тио	PROPN
Тип	PROPN
Тир	PROPN
Тит	PROPN
Тия	PROPN
Тог	PROPN
Ток	PROPN
Том	PROPN
Топ	PROPN
Тор	PROPN
Тот	PROPN
Тох	PROPN
Туй	PROPN
Тун	PROPN
Тур	PROPN
Тут	PROPN
Туш	PROPN
Туя	PROPN
Тыв	PROPN
Тым	PROPN
Тып	PROPN
Тыт	PROPN
Тыч	PROPN
Тыш	PROPN
Тэн	PROPN
Тюй	PROPN
Тюп	PROPN
Уар	PROPN
Уая	PROPN
Уба	PROPN
Ува	PROPN
Уда	PROPN
Уди	PROPN
Уду	PROPN
Уды	PROPN
Удя	PROPN
Ужа	PROPN
Уза	PROPN
Узи	PROPN
Узу	PROPN
Уил	PROPN
Уки	PROPN
Улс	PROPN
Улу	PROPN
Уля	PROPN
Ума	PROPN
Уму	PROPN
Уна	PROPN
Уни	PROPN
Унч	PROPN
Упа	PROPN
Уря	PROPN
Уса	PROPN
Усу	PROPN
Ута	PROPN
Уть	PROPN
Уфа	PROPN
Уца	PROPN
Уча	PROPN
Уша	PROPN
Уяр	PROPN
Фал	PROPN
Фан	PROPN
Фас	PROPN
Фат	PROPN
Фаф	PROPN
Фая	PROPN
Феа	PROPN
Феб	PROPN
Фен	PROPN
Фер	PROPN
Фес	PROPN
Фет	PROPN
Фея	PROPN
Фил	PROPN
Фиш	PROPN
Фия	PROPN
Фор	PROPN
Фот	PROPN
Фош	PROPN
Фыр	PROPN
Фыф	PROPN
Фыч	PROPN
Фэр	PROPN
Хаз	PROPN
Хай	PROPN
Хал	PROPN
Хам	PROPN
Хан	PROPN
Хао	PROPN
Хас	PROPN
Хат	PROPN
Хау	PROPN
Хах	PROPN
Хеш	PROPN
Хив	PROPN
Хим	PROPN
Хит	PROPN
Хиу	PROPN
Хих	PROPN
Хиц	PROPN
Хич	PROPN
Хны	PROPN
Хот	PROPN
Хох	PROPN
Худ	PROPN
Хуж	PROPN
Хук	PROPN
Хун	PROPN
Хуп	PROPN
Хут	PROPN
Хуц	PROPN
Хуч	PROPN
Хшы	PROPN
Хым	PROPN
Хып	PROPN
Хыт	PROPN
Хыц	PROPN
Хыч	PROPN
Хыш	PROPN
Хюэ	PROPN
Цай	PROPN
Цан	PROPN
Цар	PROPN
Цах	PROPN
Цац	PROPN
Цим	PROPN
Цис	PROPN
Цих	PROPN
Циц	PROPN
Ция	PROPN
Цми	PROPN
Цна	PROPN
Цой	PROPN
Цох	PROPN
Цуг	PROPN
Цур	PROPN
Цуц	PROPN
Цыб	PROPN
Цык	PROPN
Цым	PROPN
Цыс	PROPN
Цых	PROPN
Цыц	PROPN
Цыю	PROPN
Цюк	PROPN
Чаб	PROPN
Чаг	PROPN
Чад	PROPN
Чаз	PROPN
Чак	PROPN
Чам	PROPN
Чан	PROPN
Чап	PROPN
Чат	PROPN
Чах	PROPN
Чач	PROPN
Чая	PROPN
Чех	PROPN
Чиж	PROPN
Чир	PROPN
Чиф	PROPN
Чич	PROPN
Чог	PROPN
Чоп	PROPN
Чоя	PROPN
Чуб	PROPN
Чуй	PROPN
Чук	PROPN
Чут	PROPN
Чуф	PROPN
Чуч	PROPN
Чуш	PROPN
Чуя	PROPN
Чхы	PROPN
Чыг	PROPN
Чыд	PROPN
Чыз	PROPN
Чык	PROPN
Чым	PROPN
Чын	PROPN
Чыр	PROPN
Чыс	PROPN
Чыт	PROPN
Чыу	PROPN
Чыф	PROPN
Чыч	PROPN
Чыш	PROPN
Шад	PROPN
Шам	PROPN
Шап	PROPN
Шат	PROPN
Шах	PROPN
Шач	PROPN
Шаш	PROPN
Шая	PROPN
Шет	PROPN
Шеу	PROPN
Шея	PROPN
Шин	PROPN
Шир	PROPN
Шис	PROPN
Шиш	PROPN
Шоу	PROPN
Шуа	PROPN
Шуя	PROPN
Шып	PROPN
Шыц	PROPN
Шюц	PROPN
Щек	PROPN
Щур	PROPN
Ыйм	PROPN
Эбу	PROPN
Эва	PROPN
Эда	PROPN
Эдо	PROPN
Эдя	PROPN
Эжи	PROPN
Эза	PROPN
Эйк	PROPN
Эйр	PROPN
Эка	PROPN
Эко	PROPN
Экс	PROPN
Эла	PROPN
Эли	PROPN
Эль	PROPN
Эля	PROPN
Эма	PROPN
Эме	PROPN
Эми	PROPN
Эмс	PROPN
Эна	PROPN
Энн	PROPN
Эня	PROPN
Эол	PROPN
Эон	PROPN
Эос	PROPN
Эра	PROPN
Эри	PROPN
Этя	PROPN
Эхо	PROPN
Эша	PROPN
Эшу	PROPN
Юва	PROPN
Юга	PROPN
Юда	PROPN
Южа	PROPN
Юка	PROPN
Юла	PROPN
Юля	PROPN
Юна	PROPN
Юнг	PROPN
Юни	PROPN
Юня	PROPN
Юон	PROPN
Юра	PROPN
Юри	PROPN
Юса	PROPN
Юси	PROPN
Юст	PROPN
Юся	PROPN
Юта	PROPN
Юци	PROPN
Юша	PROPN
Юши	PROPN
Яаш	PROPN
Ява	PROPN
Явь	PROPN
Яга	PROPN
Яго	PROPN
Яда	PROPN
Ядя	PROPN
Яеи	PROPN
Яей	PROPN
Яжа	PROPN
Яза	PROPN
Язи	PROPN
Язу	PROPN
Яик	PROPN
Яка	PROPN
Яма	PROPN
Яна	PROPN
Яня	PROPN
Япо	PROPN
Япу	PROPN
Ярг	PROPN
Яса	PROPN
Ясу	PROPN
Яся	PROPN
Яту	PROPN
Ять	PROPN
Яуа	PROPN
Яха	PROPN
Яхи	PROPN
Яху	PROPN
Яша	PROPN
